1111111111111111111111111
1P00000000000000000000C01
1011110111110111011101001
1000000100000100000100001
10111101110111011111010C1
100000000000C000000000001
1011110111110111111101C01
10000001000000000001000C1
1011110111110111111101001
100000000000C000000000CE1
1111111111111111111111111