1111111
1PC10C1
1C0C0E1
1111111