11111111111111111111111111111111111111111111111111
1P000000000000000000001111111111111111111111111111
11111111111111000000001111111111111111111111111111
10000000001110000000001111111111111111111111111111
10111111101110000000001111111111111111111111111111
10111111101110000000001111111111111111111111111111
10111111101110000000001111111111111111111111111111
10111111101110000000000000000000000000000000000001
10111111101111111111111111111111111111111111111001
10000000000000000000000000000000000000000000111001
11111111111111111111111111111111111111110000111001
11111111111111111111111111111111111111110000111001
10000000000000000000000000000000000000000000111001
10000000000000000000000000000000000000000000111001
10111111111111111111111111111111111111111111111001
10111111111111111111111111111111111111111111111001
10000000000000000000000000000000000000000000000001
10000000000000000000000000000000000000000000000001
10111111111111111111111111111111111111111111111111
10111111111111111111111111111111111111111111111111
10000000000000000000000000000000000000000000000001
10000000000000000000000000000000000000000000000001
10111111111111111111111111111111111111111111111001
10111111111111111111111111111111111111111111111001
10000000000000000000000000000000000000000000111001
10000000000000000000000000000000000000000000111001
11111111111111111111111111111111111111111111111001
11111111111111111111111111111111111111111111111001
100000000000000000000000000000000000000000000000C1
10000000000000000000000000000000000000000000000001
10111111111111111111111111111111111111111111111111
10111111111111111111111111111111111111111111111111
10000000000000000000000000000000000000000000000001
10000000000000000000000000000000000000000000000001
10111111111111111111111111111111111111111111111001
10111111111111111111111111111111111111111111111001
10000000000000000000000000000000000000000000111001
10000000000000000000000000000000000000000000111001
11111111111111111111111111111111111111111111111001
11111111111111111111111111111111111111111111111001
100000000000000000000000000000000000000000000000E1
10000000000000000000000000000000000000000000000001
11111111111111111111111111111111111111111111111111