1111111111
1P00000001
1011111101
1000C000C1
1011111101
1000000001
1011111101
10000000E1
1111111111